pić=beber
żyć=vivir
kanapka=bocadillo
ruszać=mover
biedny=pobre
kolacja=cena
robić=hacer
kino=cine
dom=casa
jeść=comer
kupować=comprar
rachunek=cuenta
kołyska=cuna
chłopiec=chico
chiński=chino
dużo=mucho
kamizelka=chaleco
czekolada=chocolate
piwo=cerveza
ludzie=gente
genialnie=genial
siłownia=gimnasio
magia=magia
brać=coger
ładny=guapo
gruby=gordo
kot=gato
duży=grande
grać=jugar
wojna=guerra
kontynuować=seguir
gitara=guitarra
scenariusz=quion
bocian=cigüeña
pingwin=pingüino
wstyd=vergüenza
cześć=hola
hotel=hotel
człowiek=hombre
poduszka=almohada
alkohol=alcohol
szynka=jamón
praca=trabajo
żyrafa=jirafa
gra=juego
pejzaż=paisaje
nazywać się=llamarse
płakać=llorar
ulica=calle
nosić=llevar
garnek=olla
kąpiel=baño
pan=señor
pani=señora
ananas=piña
ser=queso
las=bosque
chcieć=querer
malować się=maquillarse
wiosłować=remar
dookoła=alrededor
wóz=caro
twój=tuyo
dołek=hoyo
sok=zumo
lis=zorro
ryba=pez
zaczynać=comenzar
ziewać=bostezar
szkoła=escuela
pies=perro
ale=pero
kąpać się=bañarse
wygrywać=ganar
kropla=gota
gotować=cocinar
miasto=ciudad
skręcać=girar
spokojny=tranquilo
zabierać / usuwać=quitar
razem=juntos
deszcz=lluvia
krzyż=cruz
mrugnięcie=guiño
pomarańcza=naranja
auto=coche
śliwka=ciruela
zegar=reloj
rower=bicicleta
kieliszek=copa
widelec=tenedor
rzecz=cosa
cena=precio
dolina=valle
bilet=billete
kurtka=chaqueta
zeszyt=cuaderno
